111111111
10C000P01
1000E0001
111111111