11111111111111111111111111111
10000000000000000000000000001
10000000E00000000000000000001
100000000000000C0000000000001
10000000000000000000000000001
1000000000C00000000000P000001
10000000000000000000000000001
10000000000000000000000000001
10000000000000000000000000001
10000000000000000000000000001
11111111111111111111111111111