11111111
10P01001
10011C01
1000C0E1
11111111