1111111111
1000001001
1E001C0001
1111110111
1P00C00101
1111111111
