1111111111111111111111111111111111111111111111111111111111111
1111111101100001111101100001111101100111111E111110C0100000111
1111111101000001111101000001111101000111111010001010101110111
1111111101000001111101000001111101000111111010000000000100011
111111110000000111110000000111110000011111100010101010110C011
111111111110000111111110000111111110011111111110C010C01100011
1111111111100001111111100001111111100111111111111111111110111
1110000000000000000000000000000000000100000000111100000000111
1110111110000000111110000000111110000101111100000101111110111
1110111110000000111110000000111110000101111100000001111010101
111C11111110000C11111110000C1111111001C1111111111101111110111
1110100000000000100000000000100000000101000000010000111110111
1100000000000000000000000000000000000000000000000000C00110111
1101111111100001111111100001111111100011111111111111111110111
1100011111100000011111100000011111100000111111110000000000111
1110111111100000111111100000111111100101111111010C0C0C0C01011
11101111111000000111111000001111111001P1111111010000000001011
1111111111111111111111111111111111111111111111111111111111111
